"a" = (/turf/unsimulated/wall/planetary/borealis2,/area/space)
"b" = (/obj/effect/floor_decal/industrial/danger,/turf/simulated/floor/tiled/techmaint,/area/space)
"d" = (/turf/simulated/floor/tiled/techmaint,/area/space)
"e" = (/obj/machinery/atmospherics/pipe/simple/heat_exchanging,/obj/structure/railing,/obj/structure/cable/heavyduty{icon_state = "4-8"},/turf/simulated/floor/plating,/area/space)
"i" = (/obj/machinery/atmospherics/pipe/simple/heat_exchanging,/turf/simulated/floor/tiled/techmaint,/area/space)
"k" = (/obj/structure/flora/tree/pine,/turf/simulated/floor/outdoors/snow/snow/cryogaia,/area/space)
"r" = (/turf/simulated/floor/outdoors/snow/snow/snow2/cryogaia,/area/space)
"s" = (/turf/simulated/floor/plating/snow/plating/cryogaia,/area/space)
"E" = (/turf/simulated/wall/r_wall,/area/space)
"G" = (/turf/simulated/floor/outdoors/snow/snow/cryogaia,/area/space)
"K" = (/obj/effect/floor_decal/industrial/danger{dir = 1},/turf/simulated/floor/tiled/techmaint,/area/space)
"N" = (/obj/structure/flora/tree/pine,/turf/simulated/floor/outdoors/snow/snow/snow2/cryogaia,/area/space)
"T" = (/obj/machinery/atmospherics/pipe/simple/heat_exchanging,/obj/effect/floor_decal/industrial/danger{dir = 1},/turf/simulated/floor/tiled/techmaint,/area/space)
"U" = (/obj/structure/railing,/obj/structure/cable/heavyduty{icon_state = "4-8"},/turf/simulated/floor/plating,/area/space)
"V" = (/obj/machinery/atmospherics/pipe/simple/heat_exchanging,/turf/unsimulated/wall/planetary/borealis2,/area/space)
"X" = (/obj/machinery/atmospherics/pipe/simple/heat_exchanging,/obj/effect/floor_decal/industrial/danger,/turf/simulated/floor/tiled/techmaint,/area/space)
"Z" = (/obj/machinery/atmospherics/pipe/simple/heat_exchanging,/turf/simulated/wall/r_wall,/area/space)

(1,1,1) = {"
aaaaaaaaaaaaaaaaaaaaaaaaaaaaaaaaaaaaaaaaaaaaaaaaaaaaaaaaaaaaaaaaaaaaaaaaaaaaaaaaaaaaaaaaaaaaaaaaaaaaaaaaaaaaaaaaaaaaaaaaaaaaaaaaaaaaaaaaaaaaaaaaaaaaaaaaaaaaaaaa
aGGGGGGGGGGGGGGGGGGGGGGGGGGGGGGGGGGGGGGGGGGGGGGGGGGGGGGGGGGGGGGGGGGGGGGGGGGGGGGGGGGGGGGGGGGGGGGGGGGGGGGGGGGGGGGGGGGGGGGGaaaaaaaaaaaaaaaaaaaaaaaaaaaaaaaaaaaaaVaa
aGGGGGGGGGGGGGGGGGGGGGGGGGGGGGGGGGGGGGGGGGGGGGGGGGGGGGGGGGGGGGGGGGGGGGGGGGGGGGGGGGGGGGGGGGGGGGGGGGGGGGGGGGGGGGGGGGGGGGGGaaaaaaaaaaaaaaaaaaaaaaaaaaaaaaaaaaaaaVaa
aGGGGGGGGGGGGGGGGGGGGGGGGGGGGGGGGGGGGGGGGGGGGGGGGGGGGGGGGGGGGGGGGGGGGGGGGGGGGGGGGGGGGGGGGGGGGGGGGGGGGGGGGGGGGGGGGGGGGGGGaaaaaaaaaaaaaaaaaaaaaaaaaaaaaaaaaaaaaVaa
aGGGGGGGGGGGGGGGGGGGGGGGGGGGGGGGGGGGGGGGGGGGGGGGGGGGGGGGGGGGGGGGGGGGGGGGGGGGGGGGGGGGGGGGGGGGGGGGGGGGGGGGGGGGGGGGGGGGGGGGaaaaaaaaaaaaaaaaaaaaaaaaaaaaaaaaaaaaaVaa
aGGGGGGGGGGGGGGGGGGGGGGGGGGGGGGGGGGGGGGGGGGGGGGGGGGGGGGGGGGGGGGGGGGGGGGGGGGGGGGGGGGGGGGGGGGGGGGGGGGGGGGGGGGGGGGGGGGGGGGGaaaaaaaaaaaaaaaaaaaaaaaaaaaaaaaaaaaaaVaa
aGGGGGGGGGGGGGGGGGGGGGGGGGGGGGGGGGGGGGGGGGGGGGGGGGGGGGGGGGGGGGGGGGGGGGGGGGGGGGGGGGGGGGGGGGGGGGGGGGGGGGGGGGGGGGGGGGGGGGGGGGGGGGGGGGGGGaaaaaaaaaaaaaaaaaaaaaaaaVaa
aGGGGGGGGGGGGGGGGGGGGGGGGGGGGGGGGGGGGGGGGGGGGGGGGGGGGGGGGGGGGGGGGGGGGGGGGGGGGGGGGGGGGGGGGGGGGGGGGGGGGGGGGGGGGGGGGGGGGGGGGGGGGGGGGGGGGaaaaaaaaaaaaaaaaaaaaaaaaVaa
aGGGGGGGGGGGGGGGGGGGGGGGGGGGGGGGGGGGGGGGGGGGGGGGGGGGGGGGGGGGGGGGGGGGGGGGGGGGGGGGGGGGGGGGGGGGGGGGGGGGGGGGGGGGGGGGGGGGGGGGGGGGGGGGGGGGGaaaaaaaaaaaaaaaaaaaaaaaaVaa
aGGGGGGGGGGGGGGGGGGGGGGGGGGGGGGGGGGGGGGGGGGGGGGGGGGGGGGGGGGGGGGGGGGGGGGGGGGGGGGGGGGGGGGGGGGGGGGGGGGGGGGGGGGGGGGGGGGGGGGGGGGGGGGGGGGGGaaaaaaaaaaaaaaaaaaaaaaaaVaa
aGGGGGGGGGGGGGGGGGGGGGGGGGGGGGGGGGGGGGGGGGGGGGGGGGGGGGGGGGGGGGGGGGGGGGGGGGGGGGGGGGGGGGGGGGGGGGGGGGGGGGGGGGGGGGGGGGGGGGGGGGGGGGGGGGGGGGGGGaaaaaaaaaaaaaaaaaaaaVaa
aGGGGGGGGGGGGGGGGGGGGGGGGGGGGGGGGGGGGGGGGGGGGGGGGGGGGGGGGGGGGGGGGGGGGGGGGGGGGGGGGGGGGGGGGGGGGGGGGGGGGGGGGGGGGGGGGGGGGGGGGGGGGGGGGGGGGGGGGaaaaaaaaaaaaaaaaaaaaVaa
aGGGGGGGGGGGGGGGGGGGGGGGGGGGGGGGGGGGGGGGGGGGGGGGGGGGGGGGGGGGGGGGGGGGGGGGGGGGGGGGGGGGGGGGGGGGGGGGGGGGGGGGGGGGGGGGGGGGGGGGGGGGGGGGGGGGGGGGGaaaaaaaaaaaaaaaaaaaaVaa
aGGGGGGGGGGGGGGGGGGGGGGGGGGGGGGGGGGGGGGGGGGGGGGGGGGGGGGGGGGGGGGGGGGGGGGGGGGGGGGGGGGGGGGGGGGGGGGGGGGGGGGGGGGGGGGGGGGGGGGGGGGGGGGGGGGGGGGGGaaaaaaaaaaaaaaaaaaaaVaa
aGGGGGGGGGGGGGGGGGGGGGGGGGGGGGGGGGGGGGGGGGGGGGGGGGGGGGGGGGGGGGGGGGGGGGGGGGGGGGGGGGGGGGGGGGGGGGGGGGGGGGGGGGGGGGGGGGGGGGGGGGGGGGGGGGGGGGGGGaaaaaaaaaaaaaaaaaaaaVaa
aGGGGGGGGGGGGGGGGGGGGGGGGGGGGGGGGGGGGGGGGGGGGGGGGGGGGGGGGGGGGGGGGGGGGGGGGGGGGGGGGGGGGGGGGGGGGGGGGGGGGGGGGGGGGGGGGGGGGGGGGGGGGGGGGGGGGGGGGaaaaaaaaaaaaaaaaaaaaVaa
aGGGGGGGGGGGGGGGGGGGGGGGGGGGGGGGGGGGGGGGGGGGGGGGGGGGGGGGGGGGGGGGGGGGGGGGGGGGGGGGGGGGGGGGGGGGGGGGGGGGGGGGGGGGGGGGGGGGGGGGGGGGGGGGGGGGGGGGGaaaaaaaaaaaaaaaaaaaaVaa
aGGGGGGGGGGGGGGGGGGGGGGGGGGGGGGGGGGGGGGGGGGGGGGGGGGGGGGGGGGGGGGGGGGGGGGGGGGGGGGGGGGGGGGGGGGGGGGGGGGGGGGGGGGGGGGGGGGGGGGGGGGGGGGGGGGGGGGGGaaaaaaaaaaaaaaaaaaaaVaa
aGGGGGGGGGGGGGGGGGGGGGGGGGGGGGGGGGGGGGGGGGGGGGGGGGGGGGGGGGGGGGGGGGGGGGGGGGGGGGGGGGGGGGGGGGGGGGGGGGGGGGGGGGGGGGGGGGGGGGGGGGGGGGGGGGGGGGGGGaaaaaaaaaaaaaaaaaaaaVaa
aGGGGGGGGGGGGGGGGGGGGGGGGGGGGGGGGGGGGGGGGGGGGGGGGGGGGGGGGGGGGGGGGGGGGGGGGGGGGGGGGGGGGGGGGGGGGGGGGGGGGGGGGGGGGGGGGGGGGGGGGGGGGGGGGGGGGGGGGaaaaaaaaaaaaaaaaaaaaVaa
aGGGGGGGGGGGGGGGGGGGGGGGGGGGGGGGGGGGGGGGGGGGGGGGGGGGGGGGGGGGGGGGGGGGGGGGGGGGGGGGGGGGGGGGGGGGGGGGGGGGGGGGGGGGGGGGGGGGGGGGGGGGGGGGGGGGGGGGGaaaaaaaaaaaaaaaaaaaaVaa
aGGGGGGGGGGGGGGGGGGGGGGGGGGGGGGGGGGGGGGGGGGGGGGGGGGGGGGGGGGGGGGGGGGGGGGGGGGGGGGGGGGGGGGGGGGGGGGGGGGGGGGGGGGGGGGGGGGGGGGGGGGGGGGGGGGGGGGGGaaaaaaaaaaaaaaaaaaaaVaa
aGGGGGGGGGGGGGGGGGGGGGGGGGGGGGGGGGGGGGGGGGGGGGGGGGGGGGGGGGGGGGGGGGGGGGGGGGGGGGGGGGGGGGGGGGGGGGGGGGGGGGGGGGGGGGGGGGGGGGGGGGGGGGGGGGGGGGGGGaaaaaaaaaaaaaaaaaaaaVaa
aGGGGGGGGGGGGGGGGGGGGGGGGGGGGGGGGGGGGGGGGGGGGGGGGGGGGGGGGGGGGGGGGGGGGGGGGGGGGGGGGGGGGGGGGGGGGGGGGGGGGGGGGGGGGGGGGGGGGGGGGGGGGGGGGGGGGGGGGaaaaaaaaaaaaaaaaaaaaVaa
aGGGGGGGGGGGGGGGGGGGGGGGGGGGGGGGGGGGGGGGGGGGGGGGGGGGGGGGGGGGGGGGGGGGGGGGGGGGGGGGGGGGGGGGGGGGGGGGGGGGGGGGGGGGGGGGGGGGGGGGGGGGGGGGGGGGGGGGGaaaaaaaaaaaaaaaaaaaaVaa
aGGGGGGGGGGGGGGGGGGGGGGGGGGGGGGGGGGGGGGGGGGGGGGGGGGGGGGGGGGGGGGGGGGGGGGGGGGGGGGGGGGGGGGGGGGGGGGGGGGGGGGGGGGGGGGGGGGGGGGGGGGGGGGGGGGGGGGGGaaaaaaaaaaaaaaaaaaaaVaa
aGGGGGGGGGGGGGGGGGGGGGGGGGGGGGGGGGGGGGGGGGGGGGGGGGGGGGGGGGGGGGGGGGGGGGGGGGGGGGGGGGGGGGGGGGGGGGGGGGGGGGGGGGGGGGGGGGGGGGGGGGGGGGGGGGGGGGGGGaaaaaaaaaaaaaaaaaaaaVaa
aGGGGGGGGGGGGGGGGGGGGGGGGGGGGGGGGGGGGGGGGGGGGGGGGGGGGGGGGGGGGGGGGGGGGGGGGGGGGGGGGGGGGGGGGGGGGGGGGGGGGGGGGGGGGGGGGGGGGGGGGGGGGGGGGGGGGGGGGaaaaaaaaaaaaaaaaaaaaVaa
aGGGGGGGGGGGGGGGGGGGGGGGGGGGGGGGGGGGGGGGGGGGGGGGGGGGGGGGGGGGGGGGGGGGGGGGGGGGGGGGGGGGGGGGGGGGGGGGGGGGGGGGGGGGGGGGGGGGGGGGGGGGGGGGGGGGGGGGGaaaaaaaaaaaaaaaaaaaaVaa
aGGGGGGGGGGGGGGGGGGGGGGGGGGGGGGGGGGGGGGGGGGGGGGGGGGGGGGGGGGGGGGGGGGGGGGGGGGGGGGGGGGGGGGGGGGGGGGGGGGGGGGGGGGGGGGGGGGGGGGGGGGGGGGGGGGGGGGGGaaaaaaaaaaaaaaaaaaaaVaa
aGGGGGGGGGGGGGGGGGGGGGGGGGGGGGGGGGGGGGGGGGGGGGGGGGGGGGGGGGGGGGGGGGGGGGGGGGGGGGGGGGGGGGGGGGGGGGGGGGGGGGGGGGGGGGGGGGGGGGGGGGGGGGGGGGGGGGGGGaaaaaaaaaaaaaaaaaaaaVaa
aGGGGGGGGGGGGGGGGGGGGGGGGGGGGGGGGGGGGGGGGGGGGGGGGGGGGGGGGGGGGGGGGGGGGGGGGGGGGGGGGGGGGGGGGGGGGGGGGGGGGGGGGGGGGGGGGGGGGGGGGGGGGGGGGGGGGGGGGaaaaaaaaaaaaaaaaaaaaVaa
aGGGGGGGGGGGGGGGGGGGGGGGGGGGGGGGGGGGGGGGGGGGGGGGGGGGGGGGGGGGGGGGGGGGGGGGGGGGGGGGGGGGGGGGGGGGGGGGGGGGGGGGGGGGGGGGGGGGGGGGGGGGGGGGGGGGGGGGGaaaaaaaaaaaaaaaaaaaaVaa
aGGGGGGGGGGGGGGGGGGGGGGGGGGGGGGGGGGGGGGGGGGGGGGGGGGGGGGGGGGGGGGGGGGGGGGGGGGGGGGGGGGGGGGGGGGGGGGGGGGGGGGGGGGGGGGGGGGGGGGGGGGGGGGGGGGGGGGGGaaaaaaaaaaaaaaaaaaaaVaa
aGGGGGGGGGGGGGGGGGGGGGGGGGGGGGGGGGGGGGGGGGGGGGGGGGGGGGGGGGGGGGGGGGGGGGGGGGGGGGGGGGGGGGGGGGGGGGGGGGGGGGGGGGGGGGGGGGGGGGGGGGGGGGGGGGGGGGGGGaaaaaaaaaaaaaaaaaaaaVaa
aGGGGGGGGGGGGGGGGGGGGGGGGGGGGGGGGGGGGGGGGGGGGGGGGGGGGGGGGGGGGGGGGGGGGGGGGGGGGGGGGGGGGGGGGGGGGGGGGGGGGGGGGGGGGGGGGGGGGGGGGGGGGGGGGGGGGGGGGaaaaaaaaaaaaaaaaaaaaVaa
aGGGGGGGGGGGGGGGGGGGGGGGGGGGGGGGGGGGGGGGGGGGGGGGGGGGGGGGGGGGGGGGGGGGGGGGGGGGGGGGGGGGGGGGGGGGGGGGGGGGGGGGGGGGGGGGGGGGGGGGGGGGGGGGGGGGGGGGGaaaaaaaaaaaaaaaaaaaaVaa
aGGGGGGGGGGGGGGGGGGGGGGGGGGGGGGGGGGGGGGGGGGGGGGGGGGGGGGGGGGGGGGGGGGGGGGGGGGGGGGGGGGGGGGGGGGGGGGGGGGGGGGGGGGGGGGGGGGGGGGGGGGGGGGGGGGGGGGGGaaaaaaaaaaaaaaaaaaaaVaa
aGGGGGGGGGGGGGGGGGGGGGGGGGGGGGGGGGGGGGGGGGGGGGGGGGGGGGGGGGGGGGGGGGGGGGGGGGGGGGGGGGGGGGGGGGGGGGGGGGGGGGGGGGGGGGGGGGGGGGGGGGGGGGGGGGGGGGGGGaaaaaaaaaaaaaaaaaaaaVaa
aGGGGGGGGGGGGGGGGGGGGGGGGGGGGGGGGGGGGGGGGGGGGGGGGGGGGGGGGGGGGGGGGGGGGGGGGGGGGGGGGGGGGGGGGGGGGGGGGGGGGGGGGGGGGGGGGGGGGGGGGGGGGGGGGGGGGGGGGGGGGaaaaaaaaaaaaaaaaVaa
aGGGGGGGGGGGGGGGGGGGGGGGGGGGGGGGGGGGGGGGGGGGGGGGGGGGGGGGGGGGGGGGGGGGGGGGGGGGGGGGGGGGGGGGGGGGGGGGGGGGGGGGGGGGGGGGGGGGGGGGGGGGGGGGGGGGGGGGGGGGGaaaaaaaaaaaaaaaaVaa
aGGGGGGGGGGGGGGGGGGGGGGGGGGGGGGGGGGGGGGGGGGGGGGGGGGGGGGGGGGGGGGGGGGGGGGGGGGGGGGGGGGGGGGGGGGGGGGGGGGGGGGGGGGGGGGGGGGGGGGGGGGGGGGGGGGGGGGGGGGGGaaaaaaaaaaaaaaaaVaa
aGGGGGGGGGGGGGGGGGGGGGGGGGGGGGGGGGGGGGGGGGGGGGGGGGGGGGGGGGGGGGGGGGGGGGGGGGGGGGGGGGGGGGGGGGGGGGGGGGGGGGGGGGGGGGGGGGGGGGGGGGGGGGGGGGGGGGGGGGGGGaaaaaaaaaaaaaaaaVaa
aGGGGGGGGGGGGGGGGGGGGGGGGGGGGGGGGGGGGGGGGGGGGGGGGGGGGGGGGGGGGGGGGGGGGGGGGGGGGGGGGGGGGGGGGGGGGGGGGGGGGGGGGGGGGGGGGGGGGGGGGGGGGGGGGGGGGGGGGGGGGaaaaaaaaaaaaaaaaVaa
aGGGGGGGGGGGGGGGGGGGGGGGGGGGGGGGGGGGGGGGGGGGGGGGGGGGGGGGGGGGGGGGGGGGGGGGGGGGGGGGGGGGGGGGGGGGGGGGGGGGGGGGGGGGGGGGGGGGGGGGGGGGGGGGGGGGGGGGGGGGGaaaaaaaaaaaaaaaaVaa
aGGGGGGGGGGGGGGGGGGGGGGGGGGGGGGGGGGGGGGGGGGGGGGGGGGGGGGGGGGGGGGGGGGGGGGGGGGGGGGGGGGGGGGGGGGGGGGGGGGGGGGGGGGGGGGGGGGGGGGGGGGGGGGGGGGGGGGGGGGGGaaaaaaaaaaaaaaaaVaa
aGGGGGGGGGGGGGGGGGGGGGGGGGGGGGGGGGGGGGGGGGGGGGGGGGGGGGGGGGGGGGGGGGGGGGGGGGGGGGGGGGGGGGGGGGGGGGGGGGGGGGGGGGGGGGGGGGGGGGGGGGGGGGGGGGGGGGGGGGGGGaaaaaaaaaaaaaaaaVaa
aGGGGGGGGGGGGGGGGGGGGGGGGGGGGGGGGGGGGGGGGGGGGGGGGGGGGGGGGGGGGGGGGGGGGGGGGGGGGGGGGGGGGGGGGGGGGGGGGGGGGGGGGGGGGGGGGGGGGGGGGGGGGGGGGGGGGGGGGGGGGaaaaaaaaaaaaaaaaVaa
aGGGGGGGGGGGGGGGGGGGGGGGGGGGGGGGGGGGGGGGGGGGGGGGGGGGGGGGGGGGGGGGGGGGGGGGGGGGGGGGGGGGGGGGGGGGGGGGGGGGGGGGGGGGGGGGGGGGGGGGGGGGGGGGGGGGGGGGGGGGGaaaaaaaaaaaaaaaaVaa
aGGGGGGGGGGGGGGGGGGGGGGGGGGGGGGGGGGGGGGGGGGGGGGGGGGGGGGGGGGGGGGGGGGGGGGGGGGGGGGGGGGGGGGGGGGGGGGGGGGGGGGGGGGGGGGGGGGGGGGGGGGGGGGGGGGGGGGGGGGGGaaaaaaaaaaaaaaaaVaa
aGGGGGGGGGGGGGGGGGGGGGGGGGGGGGGGGGGGGGGGGGGGGGGGGGGGGGGGGGGGGGGGGGGGGGGGGGGGGGGGGGGGGGGGGGGGGGGGGGGGGGGGGGGGGGGGGGGGGGGGGGGGGGGGGGGGGGGGGGGGGaaaaaaaaaaaaaaaaVaa
aGGGGGGGGGGGGGGGGGGGGGGGGGGGGGGGGGGGGGGGGGGGGGGGGGGGGGGGGGGGGGGGGGGGGGGGGGGGGGGGGGGGGGGGGGGGGGGGGGGGGGGGGGGGGGGGGGGGGGGGGGGGGGGGGGGGGGGGGGGGGaaaaaaaaaaaaaaaaVaa
aGGGGGGGGGGGGGGGGGGGGGGGGGGGGGGGGGGGGGGGGGGGGGGGGGGGGGGGGGGGGGGGGGGGGGGGGGGGGGGGGGGGGGGGGGGGGGGGGGGGGGGGGGGGGGGGGGGGGGGGGGGGGGGGGGGGGGGGGGGGGaaaaaaaaaaaaaaaaVaa
aGGGGGGGGGGGGGGGGGGGGGGGGGGGGGGGGGGGGGGGGGGGGGGGGGGGGGGGGGGGGGGGGGGGGGGGGGGGGGGGGGGGGGGGGGGGGGGGGGGGGGGGGGGGGGGGGGGGGGGGGGGGGGGGGGGGGGGGGGGGGaaaaaaaaaaaaaaaaVaa
aGGGGGGGGGGGGGGGGGGGGGGGGGGGGGGGGGGGGGGGGGGGGGGGGGGGGGGGGGGGGGGGGGGGGGGGGGGGGGGGGGGGGGGGGGGGGGGGGGGGGGGGGGGGGGGGGGGGGGGGGGGGGGGGGGGGGGGGGGGGGaaaaaaaaaaaaaaaaVaa
aGGGGGGGGGGGGGGGGGGGGGGGGGGGGGGGGGGGGGGGGGGGGGGGGGGGGGGGGGGGGGGGGGGGGGGGGGGGGGGGGGGGGGGGGGGGGGGGGGGGGGGGGGGGGGGGGGGGGGGGGGGGGGGGGGGGGGGGGGGGGaaaaaaaaaaaaaaaaVaa
aGGGGGGGGGGGGGGGGGGGGGGGGGGGGGGGGGGGGGGGGGGGGGGGGGGGGGGGGGGGGGGGGGGGGGGGGGGGGGGGGGGGGGGGGGGGGGGGGGGGGGGGGGGGGGGGGGGGGGGGGGGGGGGGGGGGGGGGGGGGGaaaaaaaaaaaaaaaaVaa
aGGGGGGGGGGGGGGGGGGGGGGGGGGGGGGGGGGGGGGGGGGGGGGGGGGGGGGGGGGGGGGGGGGGGGGGGGGGGGGGGGGGGGGGGGGGGGGGGGGGGGGGGGGGGGGGGGGGGGGGGGGGGGGGGGGGGGGGGGGGGaaaaaaaaaaaaaaaaVaa
aGGGGGGGGGGGGGGGGGGGGGGGGGGGGGGGGGGGGGGGGGGGGGGGGGGGGGGGGGGGGGGGGGGGGGGGGGGGGGGGGGGGGGGGGGGGGGGGGGGGGGGGGGGGGGGGGGGGGGGGGGGGGGGGGGGGGGGGGGGGGaaaaaaaaaaaaaaaaVaa
aGGGGGGGGGGGGGGGGGGGGGGGGGGGGGGGGGGGGGGGGGGGGGGGGGGGGGGGGGGGGGGGGGGGGGGGGGGGGGGGGGGGGGGGGGGGGGGGGGGGGGGGGGGGGGGGGGGGGGGGGGGGGGGGGGGGGGGGGGGGGaaaaaaaaaaaaaaaaVaa
aGGGGGGGGGGGGGGGGGGGGGGGGGGGGGGGGGGGGGGGGGGGGGGGGGGGGGGGGGGGGGGGGGGGGGGGGGGGGGGGGGGGGGGGGGGGGGGGGGGGGGGGGGGGGGGGGGGGGGGGGGGGGGGGGGGGGGGGGGGGGaaaaaaaaaaaaaaaaVaa
aGGGGGGGGGGGGGGGGGGGGGGGGGGGGGGGGGGGGGGGGGGGGGGGGGGGGGGGGGGGGGGGGGGGGGGGGGGGGGGGGGGGGGGGGGGGGGGGGGGGGGGGGGGGGGGGGGGGGGGGGGGGGGGGGGGGGGGGGGGGGaaaaaaaaaaaaaaaaVaa
aGGGGGGGGGGGGGGGGGGGGGGGGGGGGGGGGGGGGGGGGGGGGGGGGGGGGGGGGGGGGGGGGGGGGGGGGGGGGGGGGGGGGGGGGGGGGGGGGGGGGGGGGGGGGGGGGGGGGGGGGGGGGGGGGGGGGGGGGGGGGaaaaaaaaaaaaaaaaVaa
aGGGGGGGGGGGGGGGGGGGGGGGGGGGGGGGGGGGGGGGGGGGGGGGGGGGGGGGGGGGGGGGGGGGGGGGGGGGGGGGGGGGGGGGGGGGGGGGGGGGGGGGGGGGGGGGGGGGGGGGGGGGGGGGGGGGGGGGGGGGGaaaaaaaaaaaaaaaaVaa
aGGGGGGGGGGGGGGGGGGGGGGGGGGGGGGGGGGGGGGGGGGGGGGGGGGGGGGGGGGGGGGGGGGGGGGGGGGGGGGGGGGGGGGGGGGGGGGGGGGGGGGGGGGGGGGGGGGGGGGGGGGGGGGGGGGGGGGGGGGGGaaaaaaaaaaaaaaaaVaa
aGGGGGGGGGGGGGGGGGGGGGGGGGGGGGGGGGGGGGGGGGGGGGGGGGGGGGGGGGGGGGGGGGGGGGGGGGGGGGGGGGGGGGGGGGGGGGGGGGGGGGGGGGGGGGGGGGGGGGGGGGGGGGGGGGGGGGGGGGGGGaaaaaaaaaaaaaaaaVaa
aGGGGGGGGGGGGGGGGGGGGGGGGGGGGGGGGGGGGGGGGGGGGGGGGGGGGGGGGGGGGGGGGGGGGGGGGGGGGGGGGGGGGGGGGGGGGGGGGGGGGGGGGGGGGGGGGGGGGGGGGGGGGGGGGGGGGGGGGGGGGaaaaaaaaaaaaaaaaVaa
aGGGGGGGGGGGGGGGGGGGGGGGGGGGGGGGGGGGGGGGGGGGGGGGGGGGGGGGGGGGGGGGGGGGGGGGGGGGGGGGGGGGGGGGGGGGGGGGGGGGGGGGGGGGGGGGGGGGGGGGGGGGGGGGGGGGGGGGGGGGGaaaaaaaaaaaaaaaaVaa
aGGGGGGGGGGGGGGGGGGGGGGGGGGGGGGGGGGGGGGGGGGGGGGGGGGGGGGGGGGGGGGGGGGGGGGGGGGGGGGGGGGGGGGGGGGGGGGGGGGGGGGGGGGGGGGGGGGGGGGGGGGGGGGGGGGGGGGGGGGGGaaaaaaaaaaaaaaaaVaa
aGGGGGGGGGGGGGGGGGGGGGGGGGGGGGGGGGGGGGGGGGGGGGGGGGGGGGGGGGGGGGGGGGGGGGGGGGGGGGGGGGGGGGGGGGGGGGGGGGGGGGGGGGGGGGGGGGGGGGGGGGGGGGGGGGGGGGGGGGGGGaaaaaaaaaaaaaaaaVaa
aGGGGGGGGGGGGGGGGGGGGGGGGGGGGGGGGGGGGGGGGGGGGGGGGGGGGGGGGGGGGGGGGGGGGGGGGGGGGGGGGGGGGGGGGGGGGGGGGGGGGGGGGGGGGGGGGGGGGGGGGGGGGGGGGGGGGGGGGGGGGGGGaaaaaaaaaaaaaVaa
aGGGGGGGGGGGGGGGGGGGGGGGGGGGGGGGGGGGGGGGGGGGGGGGGGGGGGGGGGGGGGGGGGGGGGGGGGGGGGGGGGGGGGGGGGGGGGGGGGGGGGGGGGGGGGGGGGGGGGGGGGGGGGGGGGGGGGGGGGGGGGGGaaaaaaaaaaaaaVaa
aGGGGGGGGGGGGGGGGGGGGGGGGGGGGGGGGGGGGGGGGGGGGGGGGGGGGGGGGGGGGGGGGGGGGGGGGGGGGGGGGGGGGGGGGGGGGGGGGGGGGGGGGGGGGGGGGGGGGGGGGGGGGGGGGGGGGGGGGGGGGGGGaaaaaaaaaaaaaVaa
aGGGGGGGGGGGGGGGGGGGGGGGGGGGGGGGGGGGGGGGGGGGGGGGGGGGGGGGGGGGGGGGGGGGGGGGGGGGGGGGGGGGGGGGGGGGGGGGGGGGGGGGGGGGGGGGGGGGGGGGGGGGGGGGGGGGGGGGGGGGGGGGaaaaaaaaaaaaaVaa
aGGGGGGGGGGGGGGGGGGGGGGGGGGGGGGGGGGGGGGGGGGGGGGGGGGGGGGGGGGGGGGGGGGGGGGGGGGGGGGGGGGGGGGGGGGGGGGGGGGGGGGGGGGGGGGGGGGGGGGGGGGGGGGGGGGGGGGGGGGGGGGGaaaaaaaaaaaaaVaa
aGGGGGGGGGGGGGGGGGGGGGGGGGGGGGGGGGGGGGGGGGGGGGGGGGGGGGGGGGGGGGGGGGGGGGGGGGGGGGGGGGGGGGGGGGGGGGGGGGGGGGGGGGGGGGGGGGGGGGGGGGGGGGGGGGGGGGGGGGGGGGGGaaaaaaaaaaaaaVaa
aGGGGGGGGGGGGGGGGGGGGGGGGGGGGGGGGGGGGGGGGGGGGGGGGGGGGGGGGGGGGGGGGGGGGGGGGGGGGGGGGGGGGGGGGGGGGGGGGGGGGGGGGGGGGGGGGGGGGGGGGGGGGGGGGGGGGGGGGGGGGGGGaaaaaaaaaaaaaVaa
aGGGGGGGGGGGGGGGGGGGGGGGGGGGGGGGGGGGGGGGGGGGGGGGGGGGGGGGGGGGGGGGGGGGGGGGGGGGGGGGGGGGGGGGGGGGGGGGGGGGGGGGGGGGGGGGGGGGGGGGGGGGGGGGGGGGGGGGGGGGGGGGaaaaaaaaaaaaaVaa
aGGGGGGGGGGGGGGGGGGGGGGGGGGGGGGGGGGGGGGGGGGGGGGGGGGGGGGGGGGGGGGGGGGGGGGGGGGGGGGGGGGGGGGGGGGGGGGGGGGGGGGGGGGGGGGGGGGGGGGGGGGGGGGGGGGGGGGGGGGGGGGGaaaaaaaaaaaaaVaa
aGGGGGGGGGGGGGGGGGGGGGGGGGGGGGGGGGGGGGGGGGGGGGGGGGGGGGGGGGGGGGGGGGGGGGGGGGGGGGGGGGGGGGGGGGGGGGGGGGGGGGGGGGGGGGGGGGGGGGGGGGGGGGGGGGGGGGGGGGGGGGGGaaaaaaaaaaaaaVaa
aGGGGGGGGGGGGGGGGGGGGGGGGGGGGGGGGGGGGGGGGGGGGGGGGGGGGGGGGGGGGGGGGGGGGGGGGGGGGGGGGGGGGGGGGGGGGGGGGGGGGGGGGGGGGGGGGGGGGGGGGGGGGGGGGGGGGGGGGGGGGGGaaaaaaaaaaaaaaVaa
aGGGGGGGGGGGGGGGGGGGGGGGGGGGGGGGGGGGGGGGGGGGGGGGGGGGGGGGGGGGGGGGGGGGGGGGGGGGGGGGGGGGGGGGGGGGGGGGGGGGGGGGGGGGGGGGGGGGGGGGGGGGGGGGGGGGGGGGGGGGGGGaaaaaaaaaaaaaaVaa
aGGGGGGGGGGGGGGGGGGGGGGGGGGGGGGGGGGGGGGGGGGGGGGGGGGGGGGGGGGGGGGGGGGGGGGGGGGGGGGGGGGGGGGGGGGGGGGGGGGGGGGGGGGGGGGGGGGGGGGGGGGGGGGGGGGGGGGGGGGGGGGaaaaaaaNraaaaaVaa
aGGGGGGGGGGGGGGGGGGGGGGGGGGGGGGGGGGGGGGGGGGGGGGGGGGGGGGGGGGGGGGGGGGGGGGGGGGGGGGGGGGGGGGGGGGGGGGGGGGGGGGGGGGGGGGGGGGGGGGGGGGGGGGGGGGGGGGGGGGGGGGaaarrrrrrNaaaaVaa
aGGGGGGGGGGGGGGGGGGGGGGGGGGGGGGGGGGGGGGGGGGGGGGGGGGGGGGGGGGGGGGGGGGGGGGGGGGGGGGGGGGGGGGGGGGGGGGGGGGGGGGGGGGGGGGGGGGGGGGGGGGGGGGGGGGGGGGGGGGGGGraaarrNrrNraaaaVaa
aGGGGGGGGGGGGGGGGGGGGGGGGGGGGGGGGGGGGGGGGGGGGGGGGGGGGGGGGGGGGGGGGGGGGGGGGGGGGGGGGGGGGGGGGGGGGGGGGGGGGGGGGGGGGGGGGGGGGGGGGGGGGGGGGGGGGGGGGGGGGGrrarrrrrrraaaaaVaa
aGGGGGGGGGGGGGGGGGGGGGGGGGGGGGGGGGGGGGGGGGGGGGGGGGGGGGGGGGGGGGGGGGGGGGGGGGGGGGGGGGGGGGGGGGGGGGGGGGGGGGGGGGGGGGGGGGGGGGGGGGGGGGGGGGGGGGGGGGGGGGrrrrrNrrNraaaaaVaa
aGGGGGGGGGGGGGGGGGGGGGGGGGGGGGGGGGGGGGGGGGGGGGGGGGGGGGGGGGGGGGGGGGGGGGGGGGGGGGGGGGGGGGGGGGGGGGGGGGGGGGGGGGGGGGGGGGGGGGGGGGGGGGGGGGGGGGGGGGGGGGrrrrrrrrrraNaaaVaa
aGGGGGGGGGGGGGGGGGGGGGGGGGGGGGGGGGGGGGGGGGGGGGGGGGGGGGGGGGGGGGGGGGGGGGGGGGGGGGGGGGGGGGGGGGGGGGGGGGGGGGGGGGGGGGGGGGGGGGGGGGGGGGGGGGGGGGGGGGGGGGrNrrrrrNrrrraaaVaa
aGGGGGGGGGGGGGGGGGGGGGGGGGGGGGGGGGGGGGGGGGGGGGGGGGGGGGGGGGGGGGGGGGGGGGGGGGGGGGGGGGGGGGGGGGGGGGGGGGGGGGGGGGGGGGGGGGGGGGGGGGGGGGGGGGGGGGGGGGGGGrrrNrrNrrrrrNaaaVaa
aGGGGGGGGGGGGGGGGGGGGGGGGGGGGGGGGGGGGGGGGGGGGGGGGGGGGGGGGGGGGGGGGGGGGGGGGGGGGGGGGGGGGGGGGGGGGGGGGGGGGGGGGGGGGGGGGGGGGGGGGGGGGGGGGGGGGGGGGGGGGrrrrrNrrrrrNaaaaVaa
aGGGGGGGGGGGGGGGGGGGGGGGGGGGGGGGGGGGGGGGGGGGGGGGGGGGGGGGGGGGGGGGGGGGGGGGGGGGGGGGGGGGGGGGGGGGGGGGGGGGGGGGGGGGGGGGGGGGGGGGGGGGGGGGGGGGGGGGGGGGGrNrrrrrrNrraaaaaVaa
aGGGGGGGGGGGGGGGGGGGGGGGGGGGGGGGGGGGGGGGGGGGGGGGGGGGGGGGGGGGGGGGGGGGGGGGGGGGGGGGGGGGGGGGGGGGGGGGGGGGGGGGGGGGGGGGGGGGGGGGGGGGGGGGGGGGGGGGGGGGGrrrrrrrrrrraaaaaVaa
aGGGGGGGGGGGGGGGGGGGGGGGGGGGGGGGGGGGGGGGGGGGGGGGGGGGGGGGGGGGGGGGGGGGGGGGGGGGGGGGGGGGGGGGGGGGGGGGGGGGGGGGGGGGGGGGGGGGGGGGGGGGGGGGGGGGGGGGGGGGGrrrNrrNrrrrNakaaVaa
aGGGGGGGGGGGGGGGGGGGGGGGGGGGGGGGGGGGGGGGGGGGGGGGGGGGGGGGGGGGGGGGGGGGGGGGGGGGGGGGGGGGGGGGGGGGGGGGGGGGGGGGGGGGGGGGGGGGGGGGGGGGGGGGGGGGGGGGGGGGGGrrrNrrrrrrrrraaVaa
aGGGGGGGGGGGGGGGGGGGGGGGGGGGGGGGGGGGGGGGGGGGGGGGGGGGGGGGGGGGGGGGGGGGGGGGGGGGGGGGGGGGGGGGGGGGGGGGGGGGGGGGGGGGGGGGGGGGGGGGGGGGGGGGGGGGGGGGGGGGGGrNrrrrrrrrrrNaaVaa
aGGGGGGGGGGGGGGGGGGGGGGGGGGGGGGGGGGGGGGGGGGGGGGGGGGGGGGGGGGGGGGGGGGGGGGGGGGGGGGGGGGGGGGGGGGGGGGGGGGGGGGGGGGGGGGGGGGGGGGGGGGGGGGGGGGGGGGGGGGGGGrrrrrNrrrrrrraaVaa
aGGGGGGGGGGGGGGGGGGGGGGGGGGGGGGGGGGGGGGGGGGGGGGGGGGGGGGGGGGGGGGGGGGGGGGGGGGGGGGGGGGGGGGGGGGGGGGGGGGGGGGGGGGGGGGGGGGGGGGGGGGGGGGGGGGGGGGGGGGGGGrrNrrrrrrrrNaaaVaa
aGGGGGGGGGGGGGGGGGGGGGGGGGGGGGGGGGGGGGGGGGGGGGGGGGGGGGGGGGGGGGGGGGGGGGGGGGGGGGGGGGGGGGGGGGGGGGGGGGGGGGGGGGGGrrrrrrrrrrrrrrrrrrrrrrrrrrrrrrrrrrrrrrrrNrrrraaaaVaa
aGGGGGGGGGGGGGGGGGGGGGGGGGGGGGGGGGGGGGGGGGGGGGGGGGGGGGGGGGGGGGGGGGGGGGGGGGGGGGGGGGGGGGGGGGGGGGGGGGGGGGGGGGGGrrrrrrrrrrrrrrrrrrrrrrrrrrrrrrrrrrrNrrNrrrrrNaaaaVaa
aGGGGGGGGGGGGGGGGGGGGGGGGGGGGGGGGGGGGGGGGGGGGGGGGGGGGGGGGGGGGGGGGGGGGGGGGGGGGGGGGGGGGGGGGGGGGGGGGGGGGGGGGGGGrrrrrrrrrrrrrrrrrrrrrrrrrrrrrrrrrrrrNrrrrrrraaaaaVaa
aGGGGGGGGGGGGGGGGGGGGGGGGGGGGGGGGGGGGGGGGGGGGGGGGGGGGGGGGGGGGGGGGGGGGGGGGGGGGGGGGGGGGGGGGGGGGGGGGGGGGGGGGGGGrrrrrrrrrrrrrrrrrrrrrrrrrrrrrrrrrrrrNrrrraaaaaaaaVaa
aGGGGGGGGGGGGGGGGGGGGGGGGGGGGGGGGGGGGGGGGGGGGGGGGGGGGGGGGGGGGGGGGGGGGGGGGGGGGGGGGGGGGGGGGGGGGGGGGGGGGGGGGGGGrrrrrrrrrrrrrrrrrrrrrrrrrrrrrrrrrrrNrrrNrrNaaaaaaVaa
aGGGGGGGGGGGGGGGGGGGGGGGGGGGGGGGGGGGGGGGGGGGGGGGGGGGGGGGGGGGGGGGGGGGGGGGGGGGGGGGGGGGGGGGGGGGGGGGGGGGGGGGGGGGrrrrrrrrrrrrrrrrrrrrrrrrrrrrrrrrrrrrrrrrrrrraaaaaVaa
aGGGGGGGGGGGGGGGGGGGGGGGGGGGGGGGGGGGGGGGGGGGGGGGGGGGGGGGGGGGGGGGGGGGGGGGGGGGGGGGGGGGGGGGGGGGGGGGGGGGGGGGGGGGrrrrrrrrrrrrrrrrrrrrrrrrrrrrrrrrrrrrNrrrrrrNaaaaaVaa
aGGGGGGGGGGGGGGGGGGGGGGGGGGGGGGGGGGGGGGGGGGGGGGGGGGGGGGGGGGGGGGGGGGGGGGGGGGGGGGGGGGGGGGGGGGGGGGGGGGGGGGGGGGGrrrrrGGGGGGGGGGGGGGGGGGGGGGGGGGGGGGrrrrrrrrraaaaaVaa
aGGGGGGGGGGGGGGGGGGGGGGGGGGGGGGGGGGGGGGGGGGGGGGGGGGGGGGGGGGGGGGGGGGGGGGGGGGGGGGGGGGGGGGGGGGGGGGGGGGGGGGGGGGGrrrrrGGGGGGGGGGGGGGGGGGGGGGGGGGGGGGGrraarrraaaaaaVaa
aGGGGGGGGGGGGGGGGGGGGGGGGGGGGGGGGGGGGGGGGGGGGGGGGGGGGGGGGGGGGGGGGGGGGGGGGGGGGGGGGGGGGGGGGGGGGGGGGGGGGGGGGGGGrrrrrGGGGGGGGGGGGGGGGGGGGGGGGGGGGGGGrrraarrraaaaaVaa
aGGGGGGGGGGGGGGGGGGGGGGGGGGGGGGGGGGGGGGGGGGGGGGGGGGGGGGGGGGGGGGGGGGGGGGGGGGGGGGGGGGGGGGGGGGGGGGGGGGGGGGGGGGGrrrrrGGGGGGGGGGGGGGGGGGGGGGssssssssGrraaaNrraaaaaVaa
aGGGGGGGGGGGGGGGGGGGGGGGGGGGGGGGGGGGGGGGGGGGGGGGGGGGGGGGGGGGGGGGGGGGGGGGGGGGGGGGGGGGGGGGGGGGGGGGGGGGGGGGGGGGrrrrrGGrrrrrrrrrrrrrrrrrrrGssssssssGrraarrrraaaaaVaa
aGGGGGGGGGGGGGGGGGGGGGGGGGGGGGGGGGGGGGGGGGGGGGGGGGGGGGGGGGGGGGGGGGGGGGGGGGGGGGGGGGGGGGGGGGGGGGGGGGGGGGGGGGGGrrrrrGGrrrrrrrrrrrrrrrrrrrGssssssssGrrraarrNaaaaaVaa
aGGGGGGGGGGGGGGGGGGGGGGGGGGGGGGGGGGGGGGGGGGGGGGGGGGGGGGGGGGGGGGGGGGGGGGGGGGGGGGGGGGGGGGGGGGGGGGGGGGGGGGGGGGGrrrrrGGrrrrrrrrrrrrrrrrrrrGssssssssGrrrrrrraaaaaaVaa
aGGGGGGGGGGGGGGGGGGGGGGGGGGGGGGGGGGGGGGGGGGGGGGGGGGGGGGGGGGGGGGGGGGGGGGGGGGGGGGGGGGGGGGGGGGGGGGGGGGGGGGGGGGGrrrrrGGrrrrrrrrrrrrrrrrrrrGssssssssGrrrrrrraaaaaaVaa
aGGGGGGGGGGGGGGGGGGGGGGGGGGGGGGGGGGGGGGGGGGGGGGGGGGGGGGGGGGGGGGGGGGGGGGGGGGGGGGGGGGGGGGGGGGGGGGGGGGGGGGGGGGGrrrrrGGrrrrrrrrrrrrrrrrrrrGssssssssGGrrrrraaaaaaaVaa
aGGGGGGGGGGGGGGGGGGGGGGGGGGGGGGGGGGGGGGGGGGGGGGGGGGGGGGGGGGGGGGGGGGGGGGGGGGGGGGGGGGGGGGGGGGGGGGGGGGGGGGGGGGGrrrrrGGrrrrrGGGGGGGGGGGGGGGssssssssGGrrrraaaaaaaaVaa
aGGGGGGGGGGGGGGGGGGGGGGGGGGGGGGGGGGGGGGGGGGGGGGGGGGGGGGGGGGGGGGGGGGGGGGGGGGGGGGGGGGGGGGGGGGGGGGGGGGGGGGGGGGGrrrrrGGrrrrrGrrrrrrrrrrrrGGGGGGGGGGGGrrEaEaEaEaEaZaE
aGGGGGGGGGGGGGGGGGGGGGGGGGGGGGGGGGGGGGGGGGGGGGGGGGGGGGGGGGGGGGGGGGGGGGGGGGGGGGGGGGGGGGGGGGGGGGGGGGGGGGGGGGGGrrrrrGGrrrrrGrrrrrrrrrrrrGrrrrrrrrrrrrrrUUUUUUUUUeUU
aGGGGGGGGGGGGGGGGGGGGGGGGGGGGGGGGGGGGGGGGGGGGGGGGGGGGGGGGGGGGGGGGGGGGGGGGGGGGGGGraarrrrrrrrrrrrrrrrrrrrrrrrrrrrrrGGGGGGGGrrrrrrrrrrrrGrrrrrrrrrrrrrrKKKKKKKKKTKK
aGGGGGGGGGGGGGGGGGGGGGGGGGGGGGGGGGGGGGGGGGGGGGGGGGGGGGGGGGGGGGGGGGGGGGGGGGGGGGGGrraarrrrrrrrrrrrrrrrrrrrrrrrrrrrrGGGGGGGGrrrrrrrrrrrrGrrrrrrrrrrrrrrdddddddddidd
aGGGGGGGGGGGGGGGGGGGGGGGGGGGGGGGGGGGGGGGGGGGGGGGGGGGGGGGGGGGGGGGGGGGGGGGGGGGGGGGrraaarrrrrrrrrrrrrrrrrrrrrrrrrrrrGGGGGGGGrrrrrrrrrrrrGrrrrrrrrrrrrrrdddddddddidd
aGGGGGGGGGGGGGGGGGGGGGGGGGGGGGGGGGGGGGGGGGGGGGGGGGGGGGGGGGGGGGGGGGGGGGGGGGGGGGGGGrraarrrrrrrrrrrrrrrrrrrrrrrrrrrrGGGGGGGGrrrrrrrrrrrrGrrrrrrrrrrrrrrbbbbbbbbbXbb
aGGGGGGGGGGGGGGGGGGGGGGGGGGGGGGGGGGGGGGGGGGGGGGGGGaaaGGGGGGGGGGGGGGGGGGGGGGGGGGGGrraaarrrrrrrrrrrrrrrrrrrrrrrrrrrGGrrrrrGrrrrrrrrrrrrGGGGGGGGsssGrrEaEaEaEaEaZaE
aGGGGGGGGGGGGGGGGGGGGGGGGGGGGGGGGGGGGGGaGGGGGGGGGGaaaGGGGGGGGGGGGGrrrGGGGGGGGGGGGrrraaarrrrrrrrrrrrrrrrrrrrrrrrrrGGrrrrrGGGGGGGGGGGGGGGGGGGGGsssGrrrrraaaaaaaVaa
aGGGGGGGGGGGGGGGGGGGGGGGGGGGGGGGGGGGGGGaGGGGGGGGGGaaaGGGGGGGGGGGGGrarrGGGGGGGGGGGGrraaaarrrrrrrrrrrrrrrrrrrrrrrrrGGrrrrrGrrrrrrrrrGGrrrrrrrGGsssGrrrrraaaaaaaVaa
aGGGGGGGGGGGGGGGGGGGGGGGGGGGGGGGGGGGGGGaGGGGGGGGGGaaaGGGGGGGGGGGGGraarrGGGGGGGGGGGrrraaaarrrrrrrrrrrrrrrrrrrrrrrrGGrrrrrGrrrrrrrrrGGrrrrrrrGGsssGrrrrraaaaaaaVaa
aGGGGGGGGGGGGGGGGGGGGGGGGGGGGGGGGGGGGGaaGGGGGGGGGGaaaGGGGGGGGGGGGGraaarrGGGGGGGGGGGrraaaaarrrrrrrrrrrrrrrrrrrrrrrGGrrrrrGrrrrrrrrrGGrrrrrrrGGsssGrrrrraaaaaaaVaa
aGGGGGGGGGGGGGGGGGGGGGGGGGGGGGGGGGGGGGaaGGGGGGGGGGGaaGGGGGGGGGGGGGrraaarrGGGGGGGGGGGrraaaaarrrrrrrrrrrrrrrrrrrrrrGGrrrrrGrrrrrrrrrGGrrrrrrrGGsssGGGrrraaaaaaaVaa
aGGGGGGGGGGGGGGGGGGGGGGGGGGGGGGGGGGGGGaaGGGGGGGGGGGaaaGGGGGGGGGGGGrrraaarrrGGGGGGGGGrrraaaaaarrrrrrrrrrrrrrrrrrrrGGrrrrrGrrrrrrrrrGGrrrrrrrGGsssGGGGrraaaaaaaVaa
aGGGGGGGGGGGGGGGGGGGGGGGGGGGGGGGGGGGGaaaGGGGGGGGGGGaaaGGGGGGGGGGGGrrrraaarrrGGGGGGGGGrrraaaaaarrrrrrrrrrrrrrrrrrrGGGGGGGGrrrrrrrrrGGrrrrrrrGGsssGGGGrraaaaaaaVaa
aGGGGGGGGGGGGGGGGGGGGGGGGGGGGGGGGGGGGaaaGGGGGGGGGGGGaaGGGGGGGGGGGGrrrrraaaarrrGGGGGGGGGrrraaaaarrrrrrrrrrrrrrrrrrGGGGGGGGrrrrrrrrrGGGGGGGGGGGsssGGGGrraaaaaaaVaa
aGGGGGGGGGGGGGGGGGGGGGGGGGGGGGGGGGGGGaaGGGGGGGGGGGGGaaGGGGGGGGGGGGrrrrrraaaaarrrGGGGGGGGGGaaaaarrrrrrrrrrrrrrrrrrGGGGGGGGGGGGGGGGGGGGGGGGGGGGsssGGGGrraaaaaaaVaa
aGGGGGGGGGGGGGGGGGGGGGGGGGGGGGGGGGGGaaaGGGGGGGGGGGGGaaGGGGGGGGGGGGrrrrrrrraaaaarrrGGGGGGGGGaaaaarrrrrrrrrrrrrrrrrGGGGGGGGGGGGGGGGGGGssssssssssssGGGGGGaaaaaaaVaa
aGGGGGGGGGGGGGGGGGGGGGGGGGGGGGGGGGGGaaaGGGGGGGGGGGGGaaGGGGGGGGGGGGrrrrrrrrrraaaaarrrrGGGGGGGGaaaGGrrrrrrrrrrrrrrrGGGGGssssssssssssssssssssssssssGGGGGGaaaaaaaVaa
aGGGGGGGGGGGGGGGaaGaGGGGGGGGGGGGGGGGaaGGGGGGGGGGGGGGaaGGGGGGGGGGGGrrrrrrrrrrraaaaaaarrrrrrGGGGGGGGrrrrrrrrrrrrrrrGGGGGssssssssssssssssssssssssssGGaaaaaaaaaaaVaa
aGGGGGGGGGGGGGGGGaaaGGGGGGGGGGGGGGGaaGGGGGGGGGGGGGGGaaaGGGGGGGGGGGrrrrrrrrrrrrraaaaaaaaaraaaaGGGGGrrrrrrrrrrrrrrrGGGGGssssssssssssssssGGGGGGGGGGGaaaaaaaaaaaaVaa
aGGGGGGGGGGGGGGGGaaaGGGGGGGGGGGGGGaaaGGGGGGGGGGGGGGGaaaGGGGGGGGGGGrrrrrrrrrrrrrGGGaaaaaaaaaaaaaaaarrrrrrrrrrrrrrrGGGGGGGGGGGGGGGGGGGGGGGGGGGGGaGaaaaaaaaaaaaaVaa
aGGGGGGGGGGGGGGGGaaaGGGGGGGGGGGGGGaaaGGGGGGGGGGGGGGGGaaGGGGGGGGGGGrrrrrrrrrrrrrrrGGGaaaaaaaaaaaaaarrrrrrrrrrrrrrrGGGGGGGGGGGGGGGGGGGGGGGGGGGGaaaaaaaaaaaaaaaaVaa
aGGGGGGGGGGGGGGGGaaaGGGGGGGGGGGGGaaaGGGGGGGGGGGGGGGGGaaaGGGGGGGGGGrrrrrrrrrrrrrrrrrGGGGGaaaaaaaaaarrrrrrrrrrrrrrrGGGGGGGGGGGGGGGGGGGGGGGGGGGaaaaaaaaaaaaaaaaaVaa
aGGGGGGGGGGGGGGGGaaaGGGGGGGGGGGGaaaaGGGGGGGGGGGGGGGGGaaaGGGGGGGGGGarrrrrrrrrrrrrrrrrrGGGGGGaaaaarrrrrrrrrraaaaarrrrrrrrrrrrrrrrrrrrrrrrrrrraaaaaaaaaaaaaaaaaaVaa
aGGGGGGGGGGGGGGGGaaaGGGGGGGGGGGaaaaGGGGGGGGGGGGGGGGGGGaaGGGGGGGGGaarrrrrrrrrrrrrrrrrrrrrrrrrrrrrrrrrrrrrrrraaaaaaarrrrrrrrrrrrrrrrrrrrrrrraaaaaaaaaaaaaaaaaaaVaa
aGGGGGGGGGGGGGGGGaaaGGGGGGGGGGaaaaaGGGGGGGGGGGGGGGGGGGaaGGGGGGGGGaaarrrrrrrrrrrrrrrrrrrrrrrrrrrrrrrrrrrrrrrrGaaaaaaaaaaaarrrrrrrrrrrrrrrrraaaaaaaaaaaaaaaaaaaVaa
aGGGGGGGGGGGGGGGGaaaGGGGGGGGGaaaaaaGGGGGGGGGGGGaaGGGGGGaGGGGGGGGGGaarrrrrrrrrrrrrrrrrrrrrrrrrrrrrrrrrrrrrrrrGGGaaaaaaaaaaaGGGGGGGGGGGGGGaaaaaaaaaaaaaaaaaaaaaVaa
aGGGGGGGGGGGGGGGGGaaGGGGGGGGaaaGaaaGGGGGGGGGGGGaaGGGGGGGGGGGGGGGGGaaarrrrrrrrrrrrrrrrrrrrrrrrrrrrrrrrrrrrrrrGGGGGaaaaaaaaaaaGGGGGGGaaaaaaaaaaaaaaaaaaaaaaaaaaVaa
aGGGGGGGGGGGGGGGGGaaGGGGGGaaaGGGaaGGGGGGGGGGGGaaaGGGGGGGGGGGGGGGGGGaaaGGrrrrrrrrrrrrrrrrrrrrrrrrrrrrrrrrrrrGGGGGGGGGaaaaaaaaaaaaGGGaaaaaaaaaaaaaaaaaaaaaaaaaaVaa
aGGGGGGGGGGGGGGGGGaaGGGGGaaGGGGGaaGGGGGGGGGGaaaaGGGGGGGGGGGGGGGGGGGGaaaGGrrrrrrrrrrrrrrrrrrrrrrrrrrrrrrrGGGGGGGGGGGaaaaaaaaaaaaaaaaaaaaaaaaaaaaaaaaaaaaaaaaaaVaa
aGGGGGGGGGGGGGGGGGaaGGGGGGGGGGGGGaGGGGGGGGaaaaaaGGGGGGGGGGGGGGGGGGGGaaaaaGrrrrrrrrrrrrrGGGGGGGrrrrrrrrrGGGGGGGGGGGGaaaaaaaaaaaaaaaaaaaaaaaaaaaaaaaaaaaaaaaaaaVaa
aGGGGGGGGGGGGGGGGGaaGGGGGGGGGGGGGGGGGGGGGaaaaaaGGGGGGGGGGGGGGGGGGGGGGaaaaaGGrrrrrrrrraaaaaaaaaaarrrrraaaaaaaaaaaaaaaaaaaaaaaaaaaaaaaaaaaaaaaaaaaaaaaaaaaaaaaaVaa
aGGGGGGGGGGGGGGGGaaaaGGGGGGGGGGGGGGGGGGaaaaaaaGGGGGGGGGGGGGGGGGGGGGGGaaaaaaararrrrrrrrrrrraaaaaaarrrrrraaaaaaaaaaaaaaaaaaaaaaaaaaaaaaaaaaaaaaaaaaaaaaaaaaaaaaVaa
aGGGGGGGGGGGGGGGGGaaaGGGGGGGGGGGGGGGGaaaaaaaaGGGGGGGGGGGGGGGGGGGGGGGGGaaaaaaaaaaaaaarrrrrrrrraaaaaaarrrrrrrrrarraaaaaaaaaaaaaaaaaaaaaaaaaaaaaaaaaaaaaaaaaaaaaVaa
aGGGGGGGGGGGGGGGGGaaGGGGGGGGGaaaaaaaaaaaaaaaaGGGGGGGGGGGGGGGGGGGGaaaaaaaaaaaaaaaaaaaaaaaarrraaaaaaaaaaarrrrrrrraaaaaaaaaaaaaaaaaaaaaaaaaaaaaaaaaaaaaaaaaaaaaaVaa
aGGGGGGGGGGGGGGGGGGGGGGGGGGGGaaaaaaaaaaaaaaaaaaaaGGGGGGGGGGGGGGaaaaaaaaaaaaaaaaaaaaaaaaaaaaaaaaaaaaaaaaaaaaaaaaaaaaaaaaaaaaaaaaaaaaaaaaaaaaaaaaaaaaaaaaaaaaaaVaa
aaaaaaaaaaaaaaaaaaaaaaaaaaaaaaaaaaaaaaaaaaaaaaaaaGGGGGaGGaGGGGGGGGGaaaaaaaaaaaaaaaaaaaaaaaaaaaaaaaaaaaaaaaaaaaaaaaaaaaaaaaaaaaaaaaaaaaaaaaaaaaaaaaaaaaaaaaaaaVaa
aaaaaaaaaaaaaaaaaaaaaaaaaaaaaaaaaaaaaaaaaaaaaaGGGGGaaaaaaaaaaaaaGGGGaaaaaaaaaaaaaaaaaaaaaaaaaaaaaaaaaaaaaaaaaaaaaaaaaaaaaaaaaaaaaaaaaaaaaaaaaaaaaaaaaaaaaaaaaVaa
aaaaaaaaaaaaaaaaaaaaaaaaaaaaaaaaaaaaaaaaaaaaaaaaaaaaaaaaaaaaaaaaaaaaaaaaaaaaaaaaaaaaaaaaaaaaaaaaaaaaaaaaaaaaaaaaaaaaaaaaaaaaaaaaaaaaaaaaaaaaaaaaaaaaaaaaaaaaaVaa
aaaaaaaaaaaaaaaaaaaaaaaaaaaaaaaaaaaaaaaaaaaaaaaaaaaaaaaaaaaaaaaaaaaaaaaaaaaaaaaaaaaaaaaaaaaaaaaaaaaaaaaaaaaaaaaaaaaaaaaaaaaaaaaaaaaaaaaaaaaaaaaaaaaaaaaaaaaaaVaa
aaaaaaaaaaaaaaaaaaaaaaaaaaaaaaaaaaaaaaaaaaaaaaaaaaaaaaaaaaaaaaaaaaaaaaaaaaaaaaaaaaaaaaaaaaaaaaaaaaaaaaaaaaaaaaaaaaaaaaaaaaaaaaaaaaaaaaaaaaaaaaaaaaaaaaaaaaaaaVaa
aaaaaaaaaaaaaaaaaaaaaaaaaaaaaaaaaaaaaaaaaaaaaaaaaaaaaaaaaaaaaaaaaaaaaaaaaaaaaaaaaaaaaaaaaaaaaaaaaaaaaaaaaaaaaaaaaaaaaaaaaaaaaaaaaaaaaaaaaaaaaaaaaaaaaaaaaaaaaVaa
aaaaaaaaaaaaaaaaaaaaaaaaaaaaaaaaaaaaaaaaaaaaaaaaaaaaaaaaaaaaaaaaaaaaaaaaaaaaaaaaaaaaaaaaaaaaaaaaaaaaaaaaaaaaaaaaaaaaaaaaaaaaaaaaaaaaaaaaaaaaaaaaaaaaaaaaaaaaaVaa
aaaaaaaaaaaaaaaaaaaaaaaaaaaaaaaaaaaaaaaaaaaaaaaaaaaaaaaaaaaaaaaaaaaaaaaaaaaaaaaaaaaaaaaaaaaaaaaaaaaaaaaaaaaaaaaaaaaaaaaaaaaaaaaaaaaaaaaaaaaaaaaaaaaaaaaaaaaaaVaa
aaaaaaaaaaaaaaaaaaaaaaaaaaaaaaaaaaaaaaaaaaaaaaaaaaaaaaaaaaaaaaaaaaaaaaaaaaaaaaaaaaaaaaaaaaaaaaaaaaaaaaaaaaaaaaaaaaaaaaaaaaaaaaaaaaaaaaaaaaaaaaaaaaaaaaaaaaaaaaaa
"}
